[console_scripts]
__init__ = ixpeobssim.bin.__init__:main
xpancrkey = ixpeobssim.bin.xpancrkey:main
xpbin = ixpeobssim.bin.xpbin:main
xpbinview = ixpeobssim.bin.xpbinview:main
xpcalib = ixpeobssim.bin.xpcalib:main
xpchrgmap = ixpeobssim.bin.xpchrgmap:main
xpevtdisplay = ixpeobssim.bin.xpevtdisplay:main
xpevtstat = ixpeobssim.bin.xpevtstat:main
xpexposure = ixpeobssim.bin.xpexposure:main
xpgrppha = ixpeobssim.bin.xpgrppha:main
xpirfview = ixpeobssim.bin.xpirfview:main
xpmdp = ixpeobssim.bin.xpmdp:main
xpobsdisplay = ixpeobssim.bin.xpobsdisplay:main
xpobssim = ixpeobssim.bin.xpobssim:main
xpobsview = ixpeobssim.bin.xpobsview:main
xpophase = ixpeobssim.bin.xpophase:main
xpphase = ixpeobssim.bin.xpphase:main
xpphotonlist = ixpeobssim.bin.xpphotonlist:main
xppicorr = ixpeobssim.bin.xppicorr:main
xppimms = ixpeobssim.bin.xppimms:main
xpradialprofile = ixpeobssim.bin.xpradialprofile:main
xpselect = ixpeobssim.bin.xpselect:main
xpsimfmt = ixpeobssim.bin.xpsimfmt:main
xpsimspec = ixpeobssim.bin.xpsimspec:main
xpsonify = ixpeobssim.bin.xpsonify:main
xpsrccoords = ixpeobssim.bin.xpsrccoords:main
xpstokesalign = ixpeobssim.bin.xpstokesalign:main
xpstokesrandom = ixpeobssim.bin.xpstokesrandom:main
xpstokesshuffle = ixpeobssim.bin.xpstokesshuffle:main
xpstokessmear = ixpeobssim.bin.xpstokessmear:main
xpstripmc = ixpeobssim.bin.xpstripmc:main
xpvisibility = ixpeobssim.bin.xpvisibility:main
xpxspec = ixpeobssim.bin.xpxspec:main
