[console_scripts]
XMLGenerator = kaipy.scripts.preproc.XMLGenerator:main
block_genmpiXDMF = kaipy.scripts.postproc.block_genmpiXDMF:main
cda2wind = kaipy.scripts.preproc.cda2wind:main
dbVid = kaipy.scripts.quicklook.dbVid:main
dbpic = kaipy.scripts.quicklook.dbpic:main
dstpic = kaipy.scripts.quicklook.dstpic:main
embiggen = kaipy.scripts.postproc.embiggen:main
embiggenMIX = kaipy.scripts.postproc.embiggenMIX:main
embiggenRCM = kaipy.scripts.postproc.embiggenRCM:main
embiggenVOLT = kaipy.scripts.postproc.embiggenVOLT:main
gamerrVid = kaipy.scripts.quicklook.gamerrVid:main
gamerrpic = kaipy.scripts.quicklook.gamerrpic:main
gamsphVid = kaipy.scripts.quicklook.gamsphVid:main
genLFM = kaipy.scripts.preproc.genLFM:main
genRAIJU = kaipy.scripts.preproc.genRAIJU:main
genRCM = kaipy.scripts.preproc.genRCM:main
genXDMF = kaipy.scripts.postproc.genXDMF:main
genXLine = kaipy.scripts.postproc.genXLine:main
genmpiXDMF = kaipy.scripts.postproc.genmpiXDMF:main
helioSatComp = kaipy.scripts.datamodel.helioSatComp:main
heliomovie = kaipy.scripts.quicklook.heliomovie:main
heliopic = kaipy.scripts.quicklook.heliopic:main
ih2oh = kaipy.scripts.OHelio.ih2oh:main
mixpic = kaipy.scripts.quicklook.mixpic:main
msphParallelSatComp = kaipy.scripts.datamodel.msphParallelSatComp:main
msphPbsSatComp = kaipy.scripts.datamodel.msphPbsSatComp:main
msphSatComp = kaipy.scripts.datamodel.msphSatComp:main
msphpic = kaipy.scripts.quicklook.msphpic:main
numSteps = kaipy.scripts.postproc.numSteps:main
pitmerge = kaipy.scripts.postproc.pitmerge:main
printResTimes = kaipy.scripts.postproc.printResTimes:main
raijudst = kaipy.raiju.dst:main
raijum2m = kaipy.raiju.m2m:main
raijupic = kaipy.scripts.quicklook.raijupic:main
rbspSCcomp = kaipy.scripts.datamodel.rbspSCcomp:main
rcmDataProbe = kaipy.scripts.quicklook.rcmDataProbe:main
rcm_rbsp_satcomp = kaipy.scripts.datamodel.rcm_rbsp_satcomp:main
rcmpic = kaipy.scripts.quicklook.rcmpic:main
remixTimeSeries = kaipy.scripts.quicklook.remixTimeSeries:main
run_calcdb = kaipy.scripts.postproc.run_calcdb:main
run_ground_deltaB_analysis = kaipy.scripts.postproc.run_ground_deltaB_analysis:main
slimFL = kaipy.scripts.postproc.slimFL:main
slimh5 = kaipy.scripts.postproc.slimh5:main
slimh5_classic = kaipy.scripts.postproc.slimh5_classic:main
supermag_analysis = kaipy.scripts.postproc.supermag_analysis:main
supermag_comparison = kaipy.scripts.postproc.supermag_comparison:main
swpic = kaipy.scripts.quicklook.swpic:main
ut2mjd = kaipy.scripts.postproc.ut2mjd:main
vizTrj = kaipy.scripts.quicklook.vizTrj:main
wsa2gamera = kaipy.scripts.preproc.wsa2gamera:main
