[console_scripts]
clyc = cylc.flow.scripts.cylc:main
cylc = cylc.flow.scripts.cylc:main

[cylc.command]
broadcast = cylc.flow.scripts.broadcast:main
cat-log = cylc.flow.scripts.cat_log:main
check-versions = cylc.flow.scripts.check_versions:main
clean = cylc.flow.scripts.clean:main
client = cylc.flow.scripts.client:main
completion-server = cylc.flow.scripts.completion_server:main
config = cylc.flow.scripts.config:main
cycle-point = cylc.flow.scripts.cycle_point:main
diff = cylc.flow.scripts.diff:main
dump = cylc.flow.scripts.dump:main
ext-trigger = cylc.flow.scripts.ext_trigger:main
function-run = cylc.flow.scripts.function_run:main
get-resources = cylc.flow.scripts.get_resources:main
get-workflow-contact = cylc.flow.scripts.get_workflow_contact:main
get-workflow-version = cylc.flow.scripts.get_workflow_version:main
graph = cylc.flow.scripts.graph:main
hold = cylc.flow.scripts.hold:main
install = cylc.flow.scripts.install:main
jobs-kill = cylc.flow.scripts.jobs_kill:main
jobs-poll = cylc.flow.scripts.jobs_poll:main
jobs-submit = cylc.flow.scripts.jobs_submit:main
kill = cylc.flow.scripts.kill:main
lint = cylc.flow.scripts.lint:main
list = cylc.flow.scripts.list:main
message = cylc.flow.scripts.message:main
pause = cylc.flow.scripts.pause:main
ping = cylc.flow.scripts.ping:main
play = cylc.flow.scripts.play:main
poll = cylc.flow.scripts.poll:main
psutils = cylc.flow.scripts.psutil:main
reinstall = cylc.flow.scripts.reinstall:main
release = cylc.flow.scripts.release:main
reload = cylc.flow.scripts.reload:main
remote-init = cylc.flow.scripts.remote_init:main
remote-tidy = cylc.flow.scripts.remote_tidy:main
remove = cylc.flow.scripts.remove:main
report-timings = cylc.flow.scripts.report_timings:main [report-timings]
scan = cylc.flow.scripts.scan:cli
set = cylc.flow.scripts.set:main
show = cylc.flow.scripts.show:main
stop = cylc.flow.scripts.stop:main
subscribe = cylc.flow.scripts.subscribe:main
trigger = cylc.flow.scripts.trigger:main
tui = cylc.flow.scripts.tui:main
validate = cylc.flow.scripts.validate:main
verbosity = cylc.flow.scripts.verbosity:main
view = cylc.flow.scripts.view:main
vip = cylc.flow.scripts.validate_install_play:main
vr = cylc.flow.scripts.validate_reinstall:main
workflow-state = cylc.flow.scripts.workflow_state:main

[cylc.main_loop]
auto_restart = cylc.flow.main_loop.auto_restart
health_check = cylc.flow.main_loop.health_check
log_data_store = cylc.flow.main_loop.log_data_store [main_loop-log_data_store]
log_db = cylc.flow.main_loop.log_db [main_loop-log_db]
log_main_loop = cylc.flow.main_loop.log_main_loop [main_loop-log_main_loop]
log_memory = cylc.flow.main_loop.log_memory [main_loop-log_memory]
reset_bad_hosts = cylc.flow.main_loop.reset_bad_hosts

[cylc.post_install]
log_vc_info = cylc.flow.install_plugins.log_vc_info:main

[cylc.xtriggers]
echo = cylc.flow.xtriggers.echo
suite_state = cylc.flow.xtriggers.suite_state
wall_clock = cylc.flow.xtriggers.wall_clock
workflow_state = cylc.flow.xtriggers.workflow_state
xrandom = cylc.flow.xtriggers.xrandom
