[console_scripts]
rosa = metomi.rose.rose:rosa
rose = metomi.rose.rose:rose
rosie = metomi.rose.rose:rosie

[rose.commands]
app-run = metomi.rose.app_run:main
app-upgrade = metomi.rose.upgrade:main
check-software = metomi.rose.check_software:main
config = metomi.rose.config_cli:main
config-diff = metomi.rose.config_diff:main
config-dump = metomi.rose.config_dump:main
date = metomi.rose.date_cli:main
env-cat = metomi.rose.env_cat:main
host-select = metomi.rose.host_select:main
host-select-client = metomi.rose.host_select_client:main
macro = metomi.rose.macro:main
metadata-check = metomi.rose.metadata_check:main
metadata-gen = metomi.rose.metadata_gen:main
metadata-graph = metomi.rose.metadata_graph:main [graph]
namelist-dump = metomi.rose.namelist_dump:main
resource = metomi.rose.resource:main
task-env = metomi.rose.task_env:main
task-run = metomi.rose.task_run:main

[rosie.commands]
checkout = metomi.rosie.vc:checkout
create = metomi.rosie.vc:create
delete = metomi.rosie.vc:delete
graph = metomi.rosie.graph:main [graph]
hello = metomi.rosie.ws_client_cli:hello
id = metomi.rosie.suite_id:main
lookup = metomi.rosie.ws_client_cli:lookup
ls = metomi.rosie.ws_client_cli:list_local_suites
