[console_scripts]
ana-solution = scripts.ana_solution:main
ana-solvent = scripts.ana_solvent:main
convert-aa2cg = scripts.convert_aa2cg:main
densities = scripts.densities:main
dlm-ana-density = scripts.dlm_ana_density:main
dlm-ana-gyration = scripts.dlm_ana_gyration:main
dlm-ana-solvation = scripts.dlm_ana_solvation:main
dlm-atoms2beads = scripts.dlm_atoms2beads:main
dlm-equilibrate = scripts.dlm_equilibrate:main
dlm-production-run = scripts.dlm_production_run:main
dlm-solvate = scripts.dlm_solvate:main
dlm-visualise-dcd = scripts.dlm_visualise_dcd:main
dlm-visualise-vmd = scripts.dlm_visualise_vmd:main
gmx-add-ions-solv = scripts.bash_cli:gmx_add_ions_solv
gmx-ana-clusters = scripts.bash_cli:gmx_ana_clusters
gmx-ana-clusters-for = scripts.bash_cli:gmx_ana_clusters_for
gmx-ana-clusters-prl = scripts.bash_cli:gmx_ana_clusters_prl
gmx-ana-gyration = scripts.bash_cli:gmx_ana_gyration
gmx-ana-gyration-dirs = scripts.bash_cli:gmx_ana_gyration_dirs
gmx-ana-gyration-pieces = scripts.bash_cli:gmx_ana_gyration_pieces
gmx-ana-maxclust-for = scripts.bash_cli:gmx_ana_maxclust_for
gmx-ana-solvation = scripts.bash_cli:gmx_ana_solvation
gmx-center-cluster = scripts.bash_cli:gmx_center_cluster
gmx-equilibrate = scripts.bash_cli:gmx_equilibrate
gmx-posres-gro = scripts.bash_cli:gmx_posres_gro
gmx-run-for = scripts.bash_cli:gmx_equilibrate
gmx-setup-equil = scripts.bash_cli:gmx_setup_equil
gmx-setup-multi = scripts.bash_cli:gmx_setup_multi
namd-bilayer-calculate-ndens = scripts.namd_bilayer_calculate_ndens:main
namd-bilayer-calculate-sld = scripts.namd_bilayer_calculate_sld:main
namd-bilayer-postprocessing = scripts.namd_bilayer_postprocessing:main
namd-setup-equil = scripts.namd_setup_equil:main
namd-setup-psf = scripts.namd_setup_psf:main
namd-solvate = scripts.namd_solvate:main
shape = scripts.shape_structure:main
smiles = scripts.smiles:main
